11111111111
11111000031
10100011111
12801110041
16700010111
10101000051
11111111111